+---+---+---+---+---+---+---+---+
| S                 |           |
+---+   +---+   +   +   +---+   +
|   |       |   |   |       |   |
+   +---+   +   +   +   +---+   +
|           |   |       |       |
+   +---+---+---+---+   +   +---+
|   |               |   |       |
+   +   +---+---+   +   +---+   +
|       |       |   |       |   |
+---+---+   +   +   +---+---+   +
|   |       |   |       |       |
+   +   +   +---+---+   +---+   +
|   |   |             E |       |
+   +   +---+   +---+---+   +---+
|           |                   |
+---+---+---+---+---+---+---+---+ 
