+---+---+---+---+---+---+---+---+---+---+---+---+---+---+---+---+---+---+---+---+---+---+---+---+---+---+---+---+---+---+---+---+---+---+---+---+---+---+---+---+---+---+---+---+---+---+---+---+---+---+
| S             |   |                       |                   |       |   |                       |               |       |                   |   |                       |                       |   |
+---+---+---+   +   +   +---+   +---+   +---+   +---+---+   +   +   +   +   +   +---+---+   +---+   +---+---+   +   +---+   +   +   +---+---+   +   +   +---+   +---+---+   +   +---+---+---+   +   +   +
|           |   |       |       |       |       |           |       |       |   |       |       |               |       |   |   |           |   |   |   |       |           |   |               |       |
+   +   +   +   +   +---+   +---+---+---+   +---+   +---+---+---+---+   +---+   +   +   +   +   +---+---+---+---+---+   +   +   +---+---+   +   +   +   +   +---+   +---+---+   +   +---+   +---+---+   +
|   |   |   |   |   |   |                       |   |       |       |   |       |   |   |   |   |                   |   |   |   |   |       |   |       |       |       |       |   |       |       |   |
+   +   +---+   +   +   +---+---+---+   +---+---+   +   +---+   +   +   +   +---+   +   +---+   +   +   +   +---+---+   +   +   +   +   +---+   +   +---+---+   +---+   +   +---+   +---+---+   +   +---+
|   |   |       |       |           |       |       |   |       |       |   |   |   |       |   |   |   |   |       |   |   |       |   |   |   |   |       |       |   |   |       |           |       |
+   +   +   +---+---+   +   +---+   +---+---+   +---+   +   +---+---+---+   +   +   +---+   +   +   +   +---+   +   +   +   +---+   +   +   +   +---+   +   +   +   +   +---+   +   +   +---+---+---+   +
|   |   |   |           |   |   |               |       |   |   |               |       |       |   |           |       |       |   |   |   |       |   |   |   |   |           |   |   |           |   |
+   +   +   +   +---+---+   +   +---+---+---+---+   +---+   +   +   +---+---+---+---+   +---+---+   +---+---+---+---+---+   +   +   +   +   +---+   +   +   +---+   +---+---+---+---+   +---+---+   +   +
|   |   |   |   |           |                           |   |   |       |           |   |   |       |                   |   |   |   |   |       |       |       |           |                       |   |
+   +   +   +   +   +   +---+---+---+   +---+---+---+   +   +   +---+   +   +---+   +   +   +   +---+---+---+---+   +   +   +   +   +   +   +   +---+---+---+   +   +---+   +   +---+---+---+---+---+   +
|   |       |   |   |   |           |   |           |           |       |       |       |   |                   |   |       |       |   |   |   |       |       |       |           |               |   |
+   +---+---+---+   +---+   +---+   +   +---+   +---+---+---+   +   +---+---+   +---+---+   +---+---+---+---+   +---+---+---+---+---+   +   +---+   +   +   +---+---+---+---+---+---+   +---+---+   +   +
|       |       |       |   |   |   |           |           |   |   |       |       |           |                                       |   |       |       |                   |       |       |       |
+---+   +   +   +---+   +   +   +   +---+---+   +   +---+   +   +   +   +   +---+   +---+   +   +   +---+---+---+---+---+---+---+---+---+   +   +---+---+---+---+   +---+---+   +   +---+---+   +---+   +
|   |       |   |       |       |       |       |       |   |   |   |   |       |   |       |   |       |                   |               |   |               |   |       |       |           |       |
+   +---+---+   +   +---+---+   +---+   +   +---+---+   +   +---+   +---+   +---+   +   +---+---+---+   +   +---+---+---+   +   +---+---+---+   +---+   +---+   +   +   +   +---+---+   +---+---+   +---+
|               |                   |   |   |           |           |       |       |   |           |   |       |       |   |               |       |   |           |   |   |           |       |   |   |
+   +---+---+---+   +---+---+---+---+   +   +   +---+---+---+   +---+   +   +   +---+   +   +---+   +   +---+   +   +   +   +   +---+---+   +---+   +   +---+---+---+   +   +   +---+   +   +   +   +   +
|           |               |       |   |   |       |       |           |   |   |       |       |       |       |   |   |   |       |   |       |   |   |       |   |   |   |   |   |       |   |       |
+---+---+   +---+---+---+---+   +   +   +---+---+   +   +   +---+---+---+   +   +   +---+---+   +---+---+   +---+   +---+   +---+   +   +---+   +   +   +   +   +   +   +   +   +   +---+---+   +---+   +
|       |       |               |       |           |   |       |       |   |   |               |       |   |       |       |           |   |   |   |       |   |       |   |               |       |   |
+   +---+---+   +   +---+---+---+---+---+   +---+---+   +---+   +   +   +---+   +   +---+---+---+---+   +   +---+   +   +---+---+---+   +   +   +   +---+---+   +   +---+   +---+---+---+   +---+   +   +
|               |   |                   |   |       |   |           |           |       |               |   |       |           |       |   |                   |       |                       |       |
+   +---+---+---+   +   +---+---+---+   +   +   +   +   +---+---+---+---+---+---+---+   +---+---+   +   +   +   +   +---+---+   +   +---+   +---+---+---+---+---+   +---+---+   +---+---+---+   +---+---+
|   |           |                   |           |   |                           |                   |   |       |   |   |       |   |           |               |   |       |   |       |       |       |
+   +---+   +   +---+---+---+---+---+---+---+---+---+---+---+---+---+---+---+   +---+---+---+   +---+---+---+---+   +   +   +---+   +---+   +---+   +---+---+   +---+   +   +---+   +   +   +---+---+   +
|       |   |                           |               |                   |       |       |   |                       |   |               |               |   |       |           |   |   |       |   |
+---+   +   +---+---+---+---+---+---+   +   +---+---+   +   +---+---+---+   +---+   +   +   +   +   +---+---+---+---+---+   +   +---+---+---+   +---+---+---+   +   +---+---+---+---+   +   +   +   +   +
|   |   |   |       |           |       |           |       |       |       |       |   |   |   |   |               |       |   |           |       |           |   |           |       |   |   |   |   |
+   +   +   +   +---+   +   +---+   +---+   +---+   +---+---+   +   +   +---+   +---+   +   +---+   +---+   +---+   +   +---+---+   +---+   +---+   +   +---+---+   +   +---+   +   +---+   +   +   +   +
|   |       |       |   |           |           |           |   |       |       |       |       |           |       |               |   |       |   |               |   |       |       |       |   |   |
+   +---+---+---+   +   +---+---+---+   +---+---+---+   +   +---+   +---+   +---+   +---+---+   +---+---+---+   +---+---+---+---+---+   +---+   +   +---+---+---+---+   +   +---+---+   +---+---+   +   +
|                   |   |           |       |       |   |       |       |       |       |       |           |               |               |                   |       |   |           |       |       |
+   +---+---+---+   +   +   +   +   +---+---+   +   +---+---+   +---+   +   +   +---+   +   +---+   +---+   +---+---+---+   +   +---+---+---+---+---+---+---+   +   +---+   +   +---+---+   +---+---+   +
|           |       |   |   |   |           |   |               |   |   |   |   |       |           |       |           |       |       |               |       |   |   |   |   |           |           |
+---+---+   +   +---+   +---+   +---+---+   +   +---+---+---+---+   +   +---+   +   +---+---+---+---+   +---+   +   +---+   +---+   +   +   +---+---+   +   +---+   +   +   +   +---+---+   +   +---+---+
|           |       |           |       |       |                   |       |   |       |           |   |       |           |       |   |       |       |           |   |   |           |       |       |
+   +---+---+---+   +---+---+---+   +   +---+---+   +---+---+---+   +---+   +   +   +---+   +---+   +   +   +---+---+---+---+   +---+   +   +   +   +---+   +---+---+   +   +---+---+   +---+---+   +   +
|   |           |   |       |       |           |   |       |   |       |   |       |       |           |   |               |   |       |   |   |   |       |       |           |   |           |   |   |
+   +---+   +---+   +   +   +   +---+---+   +---+   +   +   +   +   +---+   +---+---+   +---+---+---+   +   +   +---+---+---+   +   +---+---+   +   +---+---+   +   +---+---+   +   +---+---+   +   +   +
|       |           |   |   |       |   |           |   |       |       |   |           |           |   |   |   |               |   |           |       |       |           |   |           |       |   |
+---+   +   +---+---+---+   +---+   +   +---+---+---+   +---+---+---+   +   +   +---+---+   +---+   +---+   +   +   +---+---+---+   +---+   +---+---+   +   +---+---+---+   +   +   +---+---+---+---+   +
|       |               |       |       |           |   |           |       |                   |           |   |           |   |       |           |   |   |   |       |   |   |   |                   |
+   +---+---+---+---+   +   +   +---+   +   +---+   +   +   +   +---+---+---+   +---+---+---+---+---+   +---+   +---+---+   +   +---+   +---+---+   +   +   +   +   +   +   +   +   +   +---+---+---+   +
|   |               |       |   |       |       |       |   |               |       |   |           |               |       |       |   |           |       |   |   |   |   |       |       |           |
+   +   +---+---+   +---+---+   +   +---+   +   +---+   +   +---+---+---+   +---+   +   +   +---+   +---+---+---+---+   +---+   +---+   +   +   +---+---+---+   +   +   +   +---+   +---+   +---+   +---+
|   |   |       |   |           |   |       |   |       |           |   |       |       |   |   |   |               |       |       |       |   |           |       |       |           |       |       |
+   +   +---+   +   +---+---+---+   +   +---+   +   +---+---+---+   +   +---+   +---+   +   +   +   +   +---+---+   +---+   +   +   +   +---+---+   +---+   +---+   +---+---+---+---+---+   +   +---+   +
|   |       |   |                   |   |       |       |       |   |   |       |       |   |       |       |               |   |       |       |       |       |       |               |   |       |   |
+   +---+   +   +---+---+---+---+---+   +   +---+---+   +---+   +   +   +   +---+   +---+   +   +---+---+   +   +---+---+---+---+---+---+   +   +   +---+---+   +---+   +   +---+---+   +---+---+   +   +
|       |       |       |               |   |               |   |   |   |               |   |   |       |   |   |           |               |       |           |   |       |   |       |       |   |   |
+   +---+---+   +   +   +   +---+---+---+   +   +---+---+   +   +   +   +---+---+---+---+   +   +   +   +   +---+   +---+   +   +---+---+---+---+---+   +---+---+   +---+---+   +   +---+   +   +   +   +
|       |       |   |       |       |   |   |   |       |       |   |               |       |       |       |       |       |   |               |       |                       |       |   |       |   |
+---+   +   +---+   +---+---+   +   +   +   +---+   +   +---+---+   +---+---+---+   +   +---+---+---+---+   +   +---+   +---+   +---+---+   +   +   +---+   +---+---+---+   +---+---+   +   +---+---+   +
|       |   |       |           |       |           |                           |   |               |       |   |   |                       |   |   |       |               |           |   |       |   |
+   +   +   +---+   +---+---+   +---+---+---+   +---+---+---+---+---+---+---+   +   +---+---+---+   +---+---+   +   +---+---+---+---+---+---+   +   +---+   +---+---+---+---+   +---+---+   +   +---+   +
|   |   |       |           |       |       |       |                       |                   |   |           |   |       |   |               |       |           |           |       |   |   |       |
+   +---+---+   +---+---+   +---+   +   +   +---+   +   +---+---+---+---+   +---+---+---+---+---+   +   +---+---+   +   +   +   +   +---+---+---+---+   +---+---+   +   +---+---+   +   +   +   +   +---+
|           |       |   |           |   |   |       |   |               |   |       |           |                   |   |   |       |               |           |                   |       |           |
+   +   +---+---+   +   +---+---+   +   +   +---+---+   +---+---+   +---+   +   +   +   +---+   +---+---+---+---+---+   +   +   +---+---+   +---+   +---+---+   +---+---+---+---+---+---+---+---+---+   +
|   |               |       |       |   |           |       |       |       |   |       |       |               |       |   |   |           |   |           |   |                               |   |   |
+   +---+---+---+---+   +   +   +---+   +---+---+   +---+   +   +---+   +---+   +---+---+   +---+   +---+---+   +   +---+   +   +---+   +---+   +   +---+---+   +   +---+---+---+---+---+---+   +   +   +
|   |                   |   |       |   |       |           |           |       |           |       |           |       |   |           |   |       |           |       |   |                   |       |
+   +---+---+   +---+---+   +---+   +   +   +   +---+---+---+   +---+---+   +---+   +---+---+---+   +   +---+---+---+   +   +---+---+---+   +   +---+   +---+---+---+   +   +   +---+---+---+---+   +---+
|           |       |       |       |   |   |   |       |       |               |       |           |       |           |   |   |           |       |                       |           |           |   |
+---+---+   +---+   +   +---+   +---+   +   +---+   +   +   +---+   +---+---+   +---+   +   +---+---+---+   +   +   +---+   +   +   +---+   +---+   +---+---+---+---+---+---+---+---+   +---+---+   +   +
|       |       |   |       |   |       |           |       |       |       |   |           |           |   |   |       |   |           |                   |                       |           |       |
+   +   +---+   +   +---+---+   +   +---+   +---+---+---+---+---+---+   +   +   +---+---+---+   +   +---+   +---+---+   +   +---+---+   +---+---+---+---+---+   +---+---+---+---+   +   +---+   +---+   +
|   |       |   |   |           |   |   |   |   |                       |   |               |   |   |                   |       |                   |       |   |   |               |   |       |   |   |
+   +---+   +   +   +   +---+---+   +   +   +   +   +   +---+---+---+---+   +   +---+---+   +---+   +   +---+---+---+---+---+   +---+---+---+---+---+   +   +   +   +   +---+---+---+---+   +---+   +   +
|   |   |       |   |   |   |       |       |       |   |       |       |   |           |       |           |               |                           |   |   |       |               |   |           |
+   +   +---+---+   +   +   +   +---+---+   +---+   +   +   +---+   +   +   +   +---+---+---+   +---+---+---+   +---+---+   +---+---+---+---+---+---+---+   +   +   +---+   +---+---+   +   +   +---+---+
|   |           |           |           |       |   |   |           |       |   |           |                   |   |       |                   |       |       |   |           |           |   |       |
+   +   +---+   +   +---+---+---+   +   +---+   +---+   +---+---+---+---+   +---+   +---+   +---+---+---+   +---+   +   +---+---+---+   +---+---+   +   +---+---+   +---+   +   +   +---+---+   +   +---+
|   |       |           |       |   |   |       |       |               |           |   |       |       |       |   |       |           |           |           |       |   |   |   |       |   |       |
+   +---+   +---+---+---+   +   +---+   +   +---+   +   +   +---+---+   +---+---+---+   +---+   +   +   +---+   +   +---+   +   +---+---+   +---+---+---+---+   +---+   +   +   +---+   +   +   +---+   +
|   |   |   |               |   |       |       |   |   |   |       |       |       |       |       |       |           |   |   |           |   |           |           |   |           |   |   |       |
+   +   +   +   +---+---+---+   +   +---+---+   +   +---+   +---+   +---+   +   +   +   +---+---+---+---+   +---+   +---+   +   +   +---+---+   +   +   +   +---+---+---+   +---+---+---+   +   +   +   +
|   |       |   |           |       |       |   |       |   |           |       |   |                   |       |   |       |       |           |   |   |   |               |           |   |       |   |
+   +   +---+   +---+   +---+---+---+   +---+   +   +   +   +   +---+   +---+---+   +   +---+   +---+---+---+   +---+   +---+   +---+---+   +---+   +   +---+   +---+---+---+---+---+   +   +---+---+   +
|   |       |       |               |           |   |   |       |       |       |   |       |                   |       |   |       |       |       |       |                   |       |   |           |
+   +   +---+---+   +   +   +---+---+   +---+---+---+   +---+   +---+---+   +   +   +---+   +---+---+---+---+---+   +---+   +---+   +   +---+   +---+---+   +---+---+---+---+   +   +   +   +   +---+---+
|   |   |           |   |                               |       |           |       |   |           |           |   |           |   |               |   |                           |   |   |       |   |
+   +   +   +---+---+---+   +---+---+   +---+---+---+---+   +---+   +---+---+---+---+   +---+---+   +   +---+   +   +---+---+   +   +---+---+---+   +   +---+---+---+   +---+---+---+---+   +---+   +   +
|   |   |   |           |   |       |   |           |       |       |       |               |       |   |   |       |       |   |               |           |       |   |                   |   |   |   |
+   +---+   +   +---+   +   +   +   +---+   +---+   +   +---+   +---+   +   +---+   +---+---+   +---+   +   +---+---+   +   +   +---+---+---+   +---+---+   +   +   +   +   +---+---+---+---+   +   +   +
|       |           |   |   |   |   |       |       |       |           |       |               |       |               |           |       |   |           |   |   |   |       |               |       |
+---+   +---+---+---+   +---+   +   +   +---+   +---+---+   +---+---+---+---+   +   +---+---+---+   +---+---+   +---+---+---+---+   +   +---+   +---+---+---+   +   +---+   +   +---+   +   +---+---+   +
|   |   |           |           |       |   |                   |       |   |   |   |                       |   |       |           |   |       |       |       |       |   |       |   |           |   |
+   +   +   +---+   +---+---+---+   +---+   +---+---+---+---+   +   +   +   +   +   +---+---+---+---+---+   +   +---+   +   +---+---+   +   +---+   +   +   +---+---+   +---+---+   +   +---+---+   +   +
|       |   |                   |               |           |       |       |   |                       |   |       |                   |           |       |       |               |       |   |       |
+   +---+   +---+---+---+---+   +   +---+---+   +   +---+   +---+---+   +---+   +---+---+---+---+---+   +   +---+   +---+   +---+---+---+---+---+---+---+---+   +---+---+---+---+---+---+   +   +---+---+
|   |           |           |   |   |       |   |   |   |           |   |       |                       |       |       |   |       |               |                                   |           | E |
+   +   +---+   +   +   +---+   +---+   +   +---+   +   +---+---+   +---+   +---+   +---+---+---+---+---+---+   +---+   +---+   +   +   +   +---+---+   +---+---+---+   +---+---+---+---+---+---+   +   +
|   |       |   |   |   |       |       |           |   |       |       |       |       |                       |       |       |   |   |               |           |       |       |           |   |   |
+   +---+---+   +   +   +   +---+   +---+---+---+---+   +   +   +---+   +---+   +---+   +---+---+---+   +---+---+   +---+   +---+   +   +---+---+---+---+---+   +   +---+   +   +   +   +---+   +   +   +
|               |   |               |                       |                   |                       |                       |                               |       |       |           |           |
+---+---+---+---+---+---+---+---+---+---+---+---+---+---+---+---+---+---+---+---+---+---+---+---+---+---+---+---+---+---+---+---+---+---+---+---+---+---+---+---+---+---+---+---+---+---+---+---+---+---+
